{
  "22": {
    "1": 2,
    "2": 4,
    "3": 3,
    "4": 2,
    "5": 1,
    "6": 4,
    "7": 3,
    "8": 2,
    "9": 1,
    "10": 3,
    "11": 4,
    "12": 3,
    "13": 1,
    "14": 2,
    "15": 2,
    "16": 3,
    "17": 4,
    "18": 1,
    "19": 4,
    "20": 2,
    "21": 4,
    "22": 2,
    "23": 3,
    "24": 2,
    "25": 3,
    "26": 1,
    "27": 1,
    "28": 4,
    "29": 3,
    "30": 2,
    "31": 2,
    "32": 3,
    "33": 2,
    "34": 3,
    "35": 1,
    "36": 2,
    "37": 2,
    "38": 1,
    "39": 4,
    "40": 1
  },
  "23": {
    "1": 1,
    "2": 2,
    "3": 3,
    "4": 3,
    "5": 2,
    "6": 1,
    "7": 4,
    "8": 2,
    "9": 4,
    "10": 3,
    "11": 1,
    "12": 3,
    "13": 2,
    "14": 2,
    "15": 3,
    "16": 1,
    "17": 3,
    "18": 2,
    "19": 4,
    "20": 4,
    "21": 2,
    "22": 1,
    "23": 1,
    "24": 1,
    "25": 4,
    "26": 4,
    "27": 3,
    "28": 1,
    "29": 2,
    "30": 1,
    "31": 2,
    "32": 2,
    "33": 2,
    "34": 1,
    "35": 3,
    "36": 2,
    "37": 2,
    "38": 3,
    "39": 3,
    "40": 4
  },
  "24": {
    "1": 1,
    "2": 2,
    "3": 2,
    "4": 1,
    "5": 4,
    "6": 3,
    "7": 4,
    "8": 3,
    "9": 1,
    "10": 3,
    "11": 1,
    "12": 4,
    "13": 4,
    "14": 2,
    "15": 4,
    "16": 3,
    "17": 3,
    "18": 2,
    "20": 2,
    "21": 2,
    "23": 3,
    "24": 3,
    "25": 2,
    "26": 4,
    "27": 3,
    "28": 2,
    "29": 4,
    "30": 2,
    "31": 2,
    "32": 1,
    "33": 4,
    "34": 1,
    "35": 4,
    "36": 1,
    "37": 4,
    "38": 3,
    "40": 3
  },
  "25": {
    "1": 2,
    "2": 1,
    "3": 3,
    "4": 1,
    "5": 2,
    "6": 4,
    "7": 2,
    "8": 4,
    "9": 3,
    "10": 1,
    "11": 3,
    "12": 4,
    "13": 4,
    "14": 1,
    "15": 3,
    "16": 4,
    "17": 2,
    "18": 2,
    "19": 1,
    "20": 3,
    "21": 2,
    "22": 2,
    "23": 2,
    "24": 4,
    "25": 3,
    "26": 2,
    "27": 3,
    "28": 1,
    "29": 3,
    "30": 1,
    "31": 1,
    "32": 4,
    "33": 2,
    "34": 1,
    "35": 3,
    "37": 3,
    "38": 1
  }
}